1111111111111111111111111111
1E00000C00000000000111111111
1010010100000001010111111111
1010010100000001010111111111
1P0000000V00000000C111111111
1111111111111111111111111111
1111111111111111111111111111
1111111111111111111111111111
1111111111111111111111111111
1111111111111111111111111111
1111111111111111111111111111
1111111111111111111111111111
1111111111111111111111111111
1111111111111111111111111111
1111111111111111111111111111