1111111111111111111111111111111111
1E000100000000C00000C0000000000011
1110110100100000101001000000010101
1011010010101010001001000000010101
1P0000000C00C00000000000000V0000C1
1111111111111111111111111111111111